Day,Occupant's Activity,Occupant's Zone,Zone Arrival Time (Minute),Zone Leaving Time (Minute),Stay Duration (Minute)
1,11,1,0,300,300
1,15,4,301,302,1
1,11,1,303,322,19
1,11,1,323,647,324
1,1,0,648,652,4
1,15,4,653,656,3
1,3,3,657,690,33
1,1,0,691,710,19
1,15,4,711,712,1
1,13,2,713,839,126
1,13,2,840,917,77
1,5,3,918,1009,91
1,1,0,1010,1016,6
1,9,3,1017,1029,12
1,13,2,1030,1135,105
1,13,2,1136,1165,29
1,13,2,1166,1207,41
1,13,2,1208,1349,141
1,10,3,1350,1353,3
1,12,2,1354,1439,85
2,12,2,0,61,61
2,15,4,62,63,1
2,11,1,64,540,476
2,15,4,541,542,1
2,1,0,543,568,25
2,14,4,569,577,8
2,27,1,578,585,7
2,1,0,586,597,11
2,3,3,598,616,18
2,1,0,617,624,7
2,15,4,625,627,2
2,1,0,628,1230,602
2,27,1,1231,1233,2
2,1,0,1234,1247,13
2,13,2,1248,1365,117
2,11,1,1366,1439,73
3,11,1,0,485,485
3,15,4,486,487,1
3,3,3,488,514,26
3,1,0,515,522,7
3,15,4,523,524,1
3,27,1,525,527,2
3,1,0,528,529,1
3,21,4,530,531,1
3,1,0,532,1419,887
3,15,4,1420,1421,1
3,27,1,1422,1423,1
3,1,0,1424,1428,4
3,13,2,1429,1439,10
4,13,2,0,25,25
4,10,3,26,28,2
4,13,2,29,83,54
4,11,1,84,524,440
4,15,4,525,527,2
4,27,1,528,531,3
4,3,3,532,544,12
4,1,0,545,551,6
4,25,2,552,571,19
4,1,0,572,577,5
4,1,0,578,580,2
4,15,4,581,583,2
4,1,0,584,1304,720
4,27,1,1305,1308,3
4,1,0,1309,1312,3
4,25,2,1313,1320,7
4,7,3,1321,1325,4
4,12,2,1326,1414,88
4,15,4,1415,1416,1
4,11,1,1417,1439,22
5,11,1,0,514,514
5,15,4,515,526,11
5,27,1,527,531,4
5,1,0,532,1335,803
5,15,4,1336,1337,1
5,27,1,1338,1339,1
5,1,0,1340,1341,1
5,25,2,1342,1439,97
6,12,2,0,35,35
6,11,1,36,491,455
6,15,4,492,493,1
6,3,3,494,507,13
6,18,2,508,515,7
6,9,3,516,517,1
6,27,1,518,520,2
6,15,4,521,524,3
6,1,0,525,1439,914
7,2,0,0,32,32
7,15,4,33,34,1
7,27,1,35,36,1
7,1,0,37,40,3
7,12,2,41,46,5
7,7,3,47,48,1
7,12,2,49,96,47
7,11,1,97,579,482
7,15,4,580,581,1
7,1,0,582,596,14
7,13,2,597,643,46
7,3,3,644,670,26
7,12,2,671,720,49
7,14,4,721,730,9
7,27,1,731,734,3
7,1,0,735,740,5
7,21,4,741,744,3
7,1,0,745,761,16
7,13,2,762,802,40
7,1,0,803,1439,636
8,2,0,0,921,921
8,15,4,922,925,3
8,27,1,926,927,1
8,13,2,928,961,33
8,10,3,962,966,4
8,13,2,967,976,9
8,1,0,977,984,7
8,13,2,985,997,12
8,15,4,998,999,1
8,1,0,1000,1007,7
8,14,4,1008,1020,12
8,27,1,1021,1024,3
8,1,0,1025,1040,15
8,13,2,1041,1133,92
8,10,3,1134,1137,3
8,1,0,1138,1143,5
8,12,2,1144,1336,192
8,1,0,1337,1342,5
8,12,2,1343,1365,22
8,1,0,1366,1367,1
8,12,2,1368,1439,71
9,12,2,0,24,24
9,15,4,25,26,1
9,11,1,27,526,499
9,15,4,527,528,1
9,3,3,529,551,22
9,15,4,552,553,1
9,4,3,554,563,9
9,1,0,564,568,4
9,9,3,569,570,1
9,25,2,571,586,15
9,1,0,587,621,34
9,27,1,622,626,4
9,1,0,627,637,10
9,21,4,638,639,1
9,1,0,640,1360,720
9,27,1,1361,1362,1
9,25,2,1363,1439,76
10,12,2,0,39,39
10,15,4,40,41,1
10,11,1,42,580,538
10,15,4,581,582,1
10,1,0,583,593,10
10,15,4,594,596,2
10,3,3,597,614,17
10,25,2,615,639,24
10,27,1,640,642,2
10,1,0,643,1340,697
10,15,4,1341,1343,2
10,7,3,1344,1366,22
10,1,0,1367,1373,6
10,12,2,1374,1439,65
11,12,2,0,47,47
11,11,1,48,641,593
11,15,4,642,644,2
11,1,0,645,662,17
11,25,2,663,667,4
11,15,4,668,669,1
11,1,0,670,678,8
11,3,3,679,711,32
11,12,2,712,772,60
11,1,0,773,823,50
11,27,1,824,825,1
11,1,0,826,832,6
11,9,3,833,834,1
11,1,0,835,841,6
11,21,4,842,844,2
11,1,0,845,1439,594
12,2,0,0,198,198
12,27,1,199,200,1
12,1,0,201,203,2
12,11,1,204,688,484
12,15,4,689,691,2
12,1,0,692,696,4
12,3,3,697,699,2
12,17,1,700,709,9
12,4,3,710,719,9
12,18,2,720,748,28
12,15,4,749,750,1
12,13,2,751,786,35
12,14,4,787,798,11
12,27,1,799,801,2
12,1,0,802,807,5
12,9,3,808,809,1
12,21,4,810,815,5
12,1,0,816,1439,623
13,2,0,0,85,85
13,1,0,86,88,2
13,13,2,89,139,50
13,11,1,140,556,416
13,15,4,557,560,3
13,27,1,561,566,5
13,1,0,567,575,8
13,18,2,576,594,18
13,21,4,595,597,2
13,1,0,598,1388,790
13,27,1,1389,1392,3
13,25,2,1393,1439,46
14,12,2,0,38,38
14,11,1,39,502,463
14,15,4,503,506,3
14,27,1,507,510,3
14,1,0,511,1051,540
14,27,1,1052,1268,216
14,12,2,1269,1382,113
14,15,4,1383,1384,1
14,1,0,1385,1386,1
14,11,1,1387,1439,52
15,2,0,0,80,80
15,21,4,81,83,2
15,15,4,84,87,3
15,11,1,88,582,494
15,15,4,583,584,1
15,1,0,585,597,12
15,15,4,598,599,1
15,1,0,600,651,51
15,3,3,652,670,18
15,1,0,671,692,21
15,21,4,693,694,1
15,1,0,695,1439,744
16,11,1,0,611,611
16,15,4,612,613,1
16,27,1,614,618,4
16,3,3,619,635,16
16,18,2,636,644,8
16,15,4,645,646,1
16,13,2,647,692,45
16,10,3,693,694,1
16,13,2,695,786,91
16,13,2,787,874,87
16,10,3,875,878,3
16,13,2,879,902,23
16,5,3,903,954,51
16,1,0,955,964,9
16,9,3,965,978,13
16,13,2,979,1062,83
16,1,0,1063,1076,13
16,15,4,1077,1079,2
16,13,2,1080,1118,38
16,1,0,1119,1149,30
16,15,4,1150,1151,1
16,13,2,1152,1177,25
16,7,3,1178,1183,5
16,12,2,1184,1362,178
16,1,0,1363,1371,8
16,15,4,1372,1373,1
16,12,2,1374,1439,65
17,12,2,0,2,2
17,21,4,3,6,3
17,11,1,7,594,587
17,15,4,595,596,1
17,3,3,597,627,30
17,1,0,628,634,6
17,25,2,635,652,17
17,15,4,653,654,1
17,25,2,655,790,135
17,13,2,791,824,33
17,10,3,825,826,1
17,13,2,827,914,87
17,5,3,915,937,22
17,1,0,938,944,6
17,12,2,945,1067,122
17,15,4,1068,1069,1
17,12,2,1070,1391,321
17,1,0,1392,1403,11
17,15,4,1404,1406,2
17,1,0,1407,1410,3
17,12,2,1411,1439,28
18,11,1,0,553,553
18,15,4,554,555,1
18,3,3,556,582,26
18,15,4,583,586,3
18,18,2,587,618,31
18,27,1,619,622,3
18,21,4,623,624,1
18,1,0,625,1253,628
18,12,2,1254,1348,94
18,10,3,1349,1350,1
18,13,2,1351,1391,40
18,15,4,1392,1393,1
18,13,2,1394,1432,38
18,21,4,1433,1435,2
18,11,1,1436,1439,3
19,11,1,0,539,539
19,15,4,540,541,1
19,3,3,542,569,27
19,18,2,570,583,13
19,15,4,584,585,1
19,13,2,586,631,45
19,14,4,632,638,6
19,27,1,639,642,3
19,1,0,643,657,14
19,21,4,658,661,3
19,1,0,662,1151,489
19,1,0,1152,1154,2
19,7,3,1155,1174,19
19,12,2,1175,1357,182
19,12,2,1358,1439,81
20,12,2,0,2,2
20,1,0,3,4,1
20,11,1,5,563,558
20,15,4,564,566,2
20,3,3,567,580,13
20,18,2,581,590,9
20,15,4,591,593,2
20,27,1,594,596,2
20,1,0,597,608,11
20,21,4,609,610,1
20,1,0,611,1321,710
20,1,0,1322,1329,7
20,15,4,1330,1331,1
20,12,2,1332,1439,107
21,12,2,0,57,57
21,15,4,58,59,1
21,12,2,60,61,1
21,11,1,62,532,470
21,15,4,533,535,2
21,3,3,536,555,19
21,18,2,556,565,9
21,1,0,566,568,2
21,13,2,569,635,66
21,15,4,636,637,1
21,13,2,638,832,194
21,5,3,833,842,9
21,15,4,843,844,1
21,27,1,845,846,1
21,1,0,847,876,29
21,13,2,877,1048,171
21,15,4,1049,1050,1
21,1,0,1051,1058,7
21,12,2,1059,1130,71
21,7,3,1131,1154,23
21,12,2,1155,1276,121
21,12,2,1277,1372,95
21,11,1,1373,1439,66
22,11,1,0,227,227
22,15,4,228,229,1
22,11,1,230,504,274
22,15,4,505,506,1
22,3,3,507,529,22
22,17,1,530,537,7
22,15,4,538,539,1
22,1,0,540,542,2
22,13,2,543,689,146
22,13,2,690,809,119
22,5,3,810,831,21
22,1,0,832,836,4
22,13,2,837,954,117
22,10,3,955,957,2
22,12,2,958,994,36
22,1,0,995,997,2
22,13,2,998,1112,114
22,13,2,1113,1156,43
22,19,3,1157,1176,19
22,12,2,1177,1250,73
22,10,3,1251,1257,6
22,12,2,1258,1286,28
22,14,4,1287,1296,9
22,27,1,1297,1302,5
22,1,0,1303,1308,5
22,19,3,1309,1312,3
22,1,0,1313,1318,5
22,13,2,1319,1439,120
23,13,2,0,19,19
23,15,4,20,21,1
23,12,2,22,42,20
23,11,1,43,471,428
23,15,4,472,473,1
23,27,1,474,477,3
23,1,0,478,482,4
23,21,4,483,484,1
23,1,0,485,1270,785
23,15,4,1271,1272,1
23,1,0,1273,1292,19
23,14,4,1293,1294,1
23,27,1,1295,1296,1
23,10,3,1297,1300,3
23,12,2,1301,1339,38
23,21,4,1340,1341,1
23,12,2,1342,1410,68
23,11,1,1411,1439,28
24,11,1,0,478,478
24,15,4,479,480,1
24,27,1,481,482,1
24,13,2,483,500,17
24,15,4,501,502,1
24,13,2,503,518,15
24,3,3,519,536,17
24,18,2,537,668,131
24,3,3,669,671,2
24,13,2,672,782,110
24,13,2,783,833,50
24,5,3,834,868,34
24,18,2,869,874,5
24,6,3,875,886,11
24,25,2,887,927,40
24,13,2,928,1226,298
24,7,3,1227,1240,13
24,12,2,1241,1397,156
24,11,1,1398,1439,41
25,11,1,0,111,111
25,15,4,112,113,1
25,1,0,114,116,2
25,11,1,117,598,481
25,15,4,599,600,1
25,11,1,601,628,27
25,14,4,629,641,12
25,27,1,642,650,8
25,1,0,651,668,17
25,21,4,669,672,3
25,1,0,673,1434,761
25,27,1,1435,1437,2
25,25,2,1438,1439,1
26,25,2,0,5,5
26,15,4,6,9,3
26,11,1,10,512,502
26,15,4,513,514,1
26,27,1,515,518,3
26,21,4,519,521,2
26,17,1,522,524,2
26,2,0,525,1270,745
26,15,4,1271,1272,1
26,27,1,1273,1274,1
26,1,0,1275,1280,5
26,17,1,1281,1286,5
26,12,2,1287,1340,53
26,11,1,1341,1439,98
27,11,1,0,455,455
27,15,4,456,459,3
27,18,2,460,480,20
27,3,3,481,502,21
27,18,2,503,516,13
27,27,1,517,521,4
27,15,4,522,523,1
27,1,0,524,527,3
27,13,2,528,533,5
27,2,0,534,1204,670
27,15,4,1205,1206,1
27,27,1,1207,1216,9
27,7,3,1217,1227,10
27,12,2,1228,1439,211
28,12,2,0,18,18
28,21,4,19,21,2
28,11,1,22,614,592
28,1,0,615,618,3
28,15,4,619,621,2
28,3,3,622,645,23
28,18,2,646,654,8
28,15,4,655,659,4
28,9,3,660,661,1
28,17,1,662,698,36
28,18,2,699,739,40
28,1,0,740,752,12
28,24,3,753,796,43
28,13,2,797,824,27
28,19,3,825,836,11
28,13,2,837,930,93
28,19,3,931,940,9
28,14,4,941,961,20
28,27,1,962,975,13
28,21,4,976,982,6
28,1,0,983,988,5
28,18,2,989,1051,62
28,10,3,1052,1054,2
28,18,2,1055,1095,40
28,1,0,1096,1101,5
28,27,1,1102,1105,3
28,15,4,1106,1107,1
28,1,0,1108,1439,331
29,2,0,0,1154,1154
29,12,2,1155,1181,26
29,7,3,1182,1213,31
29,27,1,1214,1215,1
29,7,3,1216,1219,3
29,7,3,1220,1240,20
29,12,2,1241,1350,109
29,1,0,1351,1352,1
29,12,2,1353,1439,86
